[  
  {
    "type": "mapgen",
    "method": "json",
    "om_terrain": [ [ "LIXA_workfloor_1a", "LIXA_workfloor_1b" ], [ "LIXA_workfloor_2a", "LIXA_workfloor_2b" ] ],
    "object": {
      "fill_ter": "t_thconc_floor",
      "rows": [
        "//////////////////////                          ",
        "/<D../       /#,K/qKK/                          ",
        "//6/./       /h,K/,,,/                          ",
        "  //./       /,j,/,jP/                          ",
        "   /./       /a,,/h,,/                          ",
        "   /./       /B,q/#,B//////                     ",
        "   /./ ////////+///+//8888/                     ",
        "   /./ /KK,,B/A,,B,,A/8888/                     ",
        "   /./ /,jQh,+,,jE,,A/888X/                     ",
        "   /./ /q,,#,/,,h,,,A/edd////////////////       ",
        "   /./ ///////B,tth,4/..../lllluuu/bbbbb/       ",
        "   /./ /#h,fa/,,tth,o/i..i/.......9....R/       ",
        "   /./ /B,j,,+,,jh,,c/....D...i...D..i.l/       ",
        "   /./ /q,,KK/Ba,,,FF/....D......./....O/       ",
        "   /./ //////////+////....e......./bbbbb/       ",
        "   /./ /L/T/./,!#,,$$/....///dd//////////       ",
        " ///d///+/+/.+,,h,,,,d..../*******/             ",
        " /V...V/..i../,,,j,,,/i..i/*******/             ",
        " /V...V/...SS/,,,#,,,/..../*******//////////////",
        " /u...u////////////////dd//*******7/////////////",
        " /M.i........D.....i....../*******D.....C.0...//",
        " /...........D............/////////...H...H...//",
        " /w....uu....e/////////////////////.....i.....//",
        " /w...M////////////////////////////...........//",
        " /....M/*****7/////////////////////...........//",
        " /....M/*****D.....i.....;__//____>-----------//",
        " /....u/*****D...........;__//____>-----------//",
        " /V...u/7DD///////////////////________________//",
        " /V.i......../              //________________//",
        " /V........../              //________________//",
        " /...//..e/../              //________________//",
        " /////@@@@////              //________________//",
        "     /@@@@//                //________________//",
        "     /@@@@/                 //________________//",
        "     /@@@X/                 //________________//",
        "     //////                 //________________//",
        "                            //________________//",
        "                            //________________//",
        "                            //________________//",
        "                            //________________//",
        "                            //________________//",
        "                            //________________//",
        "                            //________________//",
        "                            //________________//",
        "                            //________________//",
        "                            //________________//",
        "                            //________________//",
        "                            //________________//"
      ],
      "palettes": [ "LIXA_workfloor_palette" ],
      "place_nested": [
        { "chunks": [ [ "null", 30 ], [ "LIXA_sad_graffiti", 70 ] ], "x": 21, "y": 7 },
        { "chunks": [ [ "null", 50 ], [ "LIXA_sad_graffiti", 50 ] ], "x": 13, "y": 18 },
        { "chunks": [ [ "null", 50 ], [ "LIXA_sad_graffiti", 50 ] ], "x": 14, "y": 14 },
        { "chunks": [ [ "null", 50 ], [ "LIXA_sad_graffiti", 50 ] ], "x": 21, "y": 14 },
        { "chunks": [ [ "null", 20 ], [ "LIXA_sad_graffiti", 80 ] ], "x": 14, "y": 27 },
        { "chunks": [ [ "null", 50 ], [ "LIXA_sad_graffiti", 50 ] ], "x": 14, "y": 22 },
        { "chunks": [ [ "null", 50 ], [ "LIXA_sad_graffiti", 50 ] ], "x": 26, "y": 21 },
        { "chunks": [ [ "null", 50 ], [ "LIXA_sad_graffiti", 50 ] ], "x": 1, "y": 21 },
        { "chunks": [ [ "null", 30 ], [ "LIXA_bored_graffiti", 70 ] ], "x": 26, "y": 11 },
        { "chunks": [ [ "null", 50 ], [ "LIXA_bored_graffiti", 50 ] ], "x": 22, "y": 9 },
        { "chunks": [ [ "null", 50 ], [ "LIXA_bored_graffiti", 50 ] ], "x": 19, "y": 14 },
        { "chunks": [ [ "null", 30 ], [ "LIXA_bored_graffiti", 70 ] ], "x": 21, "y": 18 },
        { "chunks": [ [ "null", 50 ], [ "LIXA_bored_graffiti", 50 ] ], "x": 11, "y": 23 },
        { "chunks": [ [ "null", 50 ], [ "LIXA_bored_graffiti", 50 ] ], "x": 26, "y": 10 },
        { "chunks": [ [ "null", 50 ], [ "LIXA_bored_graffiti", 50 ] ], "x": 13, "y": 14 },
        { "chunks": [ [ "null", 50 ], [ "LIXA_bored_graffiti", 50 ] ], "x": 17, "y": 22 },
        { "chunks": [ [ "null", 50 ], [ "LIXA_bored_graffiti", 50 ] ], "x": 19, "y": 22 },
        { "chunks": [ [ "null", 50 ], [ "LIXA_bored_graffiti", 50 ] ], "x": 21, "y": 19 },
        { "chunks": [ [ "null", 25 ], [ "LIXA_raving_graffiti", 75 ] ], "x": 29, "y": 21 },
        { "chunks": [ [ "null", 25 ], [ "LIXA_raving_graffiti", 75 ] ], "x": 32, "y": 21 },
        { "chunks": [ [ "null", 25 ], [ "LIXA_raving_graffiti", 75 ] ], "x": 34, "y": 16 },
        { "chunks": [ [ "null", 25 ], [ "LIXA_raving_graffiti", 75 ] ], "x": 30, "y": 21 },
        { "chunks": [ [ "null", 25 ], [ "LIXA_raving_graffiti", 75 ] ], "x": 45, "y": 19 },
        { "chunks": [ [ "null", 25 ], [ "LIXA_raving_graffiti", 75 ] ], "x": 46, "y": 24 },
        { "chunks": [ [ "LIXA_goodbye_graffiti", 100 ] ], "x": 34, "y": 21 }
      ],
      "items": {
        "B": [ { "item": "lab_bookshelves", "chance": 80 } ],
        "K": [ { "item": "bed", "chance": 40 } ],
        "F": [ { "item": "SUS_fridge_bachelor", "chance": 70 } ],
        "f": [ { "item": "SUS_fridge_bachelor", "chance": 70 } ],
        "#": [ { "item": "SUS_office_desk", "chance": 60 } ],
        "u": [
          { "item": "electronics", "chance": 70, "repeat": [ 1, 2 ] },
          { "item": "tools_robotics", "chance": 30, "repeat": [ 1, 2 ] }
        ],
        "V": [ { "item": "tools_robotics", "chance": 30 } ],
        "l": [ { "item": "decontamination_room", "chance": 60 } ],
        "c": [
          { "item": "SUS_dishes", "chance": 100 },
          { "item": "SUS_silverware", "chance": 100 },
          { "item": "SUS_cookware", "chance": 100 }
        ],
        "E": [ { "item": "entertainment_center_loot", "chance": 100 } ]
      },
      "item": {
        "f": [ { "item": "rootbeer", "chance": 1, "amount": [ 8, 15 ] } ],
        "$": [
          { "item": "LIXA_generic_file", "chance": 80, "repeat": [ 4, 8 ] },
          { "item": "LIXA_lab_file", "chance": 50, "repeat": 2 }
        ],
        "#": [
          { "item": "LIXA_lab_postit", "chance": 3, "repeat": 1 },
          { "item": "LIXA_lab_file", "chance": 7, "repeat": 2 },
          { "item": "software_math", "chance": 3, "repeat": 1 },
          { "item": "software_electronics_reference", "chance": 4, "repeat": 2 }
        ],
        "q": [ { "item": "adderall", "amount": [ 2, 5 ] } ],
        "E": [ { "item": "television", "amount": 1 } ],
        "R": [ { "item": "rm13_armor", "amount": 1 }, { "item": "id_LIXA_mil", "amount": 1 } ],
        "O": [ { "item": "phase_immersion_suit", "amount": 1 } ]
      },
      "place_item": [
        { "item": "heroin", "x": 11, "y": 11, "amount": [ 3, 7 ] },
        { "item": "syringe", "x": 11, "y": 11, "amount": [ 1, 3 ] },
        { "item": "headscarf", "x": 8, "y": 9, "amount": 3 },
        { "item": "teddy_bear", "x": 16, "y": 1, "amount": 1 },
        { "item": "holybook_quran", "x": 11, "y": 9, "amount": 1 },
        { "item": "holybook_hadith", "x": 12, "y": 7, "amount": 1 },
        { "item": "pride_flag", "variant": "transgender_pride_flag", "x": 18, "y": 1, "amount": 1 },
        { "item": "long_knit_scarf", "x": 18, "y": 1, "amount": 1 },
        { "item": "knit_scarf", "x": 18, "y": 1, "amount": 2 },
        { "item": "laptop", "x": 18, "y": 5, "amount": 1 },
        { "item": "software_useless", "x": 18, "y": 5, "amount": [ 4, 7 ] },
        { "item": "usb_drive_nano", "x": 18, "y": 5, "amount": 1 },
        { "item": "knitting_needles", "x": 18, "y": 5, "amount": [ 4, 8 ] },
        { "item": "yarn", "x": 18, "y": 5, "amount": [ 20, 40 ] },
        { "item": "laptop", "x": 14, "y": 1, "amount": 1 },
        { "item": "software_useless", "x": 14, "y": 1, "amount": [ 4, 7 ] },
        { "item": "paint_brush", "x": 14, "y": 1, "amount": 4 },
        { "item": "pen", "x": 14, "y": 1, "amount": 2 },
        { "item": "permanent_marker", "x": 14, "y": 1, "amount": 6 },
        { "item": "paper", "x": 14, "y": 1, "amount": [ 20, 30 ] },
        { "item": "id_LIXA_2", "x": 10, "y": 15, "amount": 1 },
        { "item": "id_LIXA_2", "x": 20, "y": 1, "amount": 1 },
        { "item": "dnd", "x": 17, "y": 10, "amount": 2 },
        { "item": "dnd_handbook", "x": 17, "y": 10, "amount": 1 },
        { "item": "RPG_die", "x": 17, "y": 10, "amount": [ 6, 12 ] }
      ],
      "place_items": [
        { "item": "SUS_book_nonf_hard", "x": 8, "y": 12, "repeat": [ 1, 2 ] },
        { "item": "SUS_book_nonf_hard", "x": 12, "y": 7 },
        { "item": "SUS_book_fict_soft_scifi", "x": 14, "y": 5 },
        { "item": "SUS_fiction_bookcase", "x": 20, "y": 5 },
        { "item": "SUS_dresser_mens", "x": 9, "y": 13 },
        { "item": "SUS_dresser_womens", "x": 9, "y": 9 },
        { "item": "jar_weed", "x": 19, "y": 1, "repeat": 1 },
        { "item": "stoner", "x": 19, "y": 5, "repeat": [ 1, 3 ] },
        { "item": "SUS_dresser_mens", "x": 19, "y": 1 },
        { "item": "stoner", "x": 15, "y": 1, "chance": 1, "repeat": [ 2, 4 ] },
        { "item": "SUS_dresser_womens", "x": 17, "y": 5 }
      ],
      "place_loot": [
        { "group": "wf_char_sheets", "x": 17, "y": 10, "repeat": [ 3, 4 ] }
      ],
      "traps": { "Q": "tr_rollmat" },
      "computers": {
        "!": {
          "name": "Personal Computer",
          "access_denied": "Credentials Unrecognized.",
          "security": 2,
          "eocs": [ "EOC_LIXA_personal_computer" ],
          "chat_topics": [ "LIXA_personal_computer_main" ]
        },
        "0": {
          "name": "Experiment Control Computer",
          "eocs": [ "EOC_LIXA_experiment_computer" ],
          "chat_topics": [ "LIXA_experiment_computer_main" ]
        }
      },
      "place_monsters": [
        { "monster": "GROUP_LAB_MAINTENANCE", "x": [ 2, 6 ], "y": [ 19, 23 ], "density": 0.1 },
        { "monster": "GROUP_LAB_MAINTENANCE", "x": [ 2, 6 ], "y": [ 25, 33 ], "density": 0.1 },
        { "monster": "GROUP_LAB_MAINTENANCE", "x": [ 15, 21 ], "y": [ 18, 21 ], "density": 0.1 }
      ]
    }
  }
]