[
  {
    "type": "mapgen",
    "method": "json",
    "om_terrain": [ "mansion_t7" ],
    "weight": 1000,
    "object": {
      "fill_ter": "t_floor",
      "rows": [
        "|   )xxx)|    |  PPrrrY|",
        "  h      |    |     h   ",
        " &&h  A  +    +         ",
        "h&&      +    +         ",
        "  h      |    |         ",
        "       AJ|>  <|         ",
        "  A    AJ|>  <|R E      ",
        "        J##oo##R --‡--- ",
        "s   ee  A#!!!!#x --‡---c",
        "H   ee  Ø#!%%!#a --‡≠-- ",
        "H   ee   o!%%!#x --‡--- ",
        "H        o!%%!#R ‡‡l--- ",
        "HHs     Æ#!%%!#R  yyyy T",
        "##ooooo###!!!!###ooooo##",
        ".%%%%%%%........%%%%%%%.",
        "........................",
        "..........[........[....",
        "........................",
        ".....[......[...........",
        "........................",
        ".................[......",
        "....[...................",
        "........[...........[...",
        "........................"
      ],
      "palettes": [ "standard_domestic_palette", "standard_domestic_lino_bathroom", "standard_domestic_landscaping_palette" ],
      "terrain": { "-": "t_carpet_green", "l": "t_carpet_green", "≠": "t_carpet_green", "‡": "t_carpet_green" },
      "furniture": { "‡": "f_sofa", "&": "f_table", ")": "f_speaker_cabinet" },
      "items": {
        ".": { "item": "clutter_yard", "chance": 1 },
        " ": { "item": "clutter_mansion", "chance": 1 },
        "l": { "item": "mansion_bookcase", "chance": 100 },
        "&": { "item": "table_card", "chance": 35 },
        "c": { "item": "suit_of_armor", "chance": 100 }
      },
      "place_loot": [
        { "item": "stereo", "x": 6, "y": 0, "chance": 100 },
        { "item": "dnd_handbook", "x": 1, "y": 2, "chance": 100 },
        { "item": "novel_fantasy", "x": [ 2, 2 ], "y": [ 3, 5 ], "chance": 60, "repeat": [ 0, 4 ] },
        { "group": "wf_char_sheets", "x": [ 1, 2 ], "y": [ 2, 3 ], "chance": 80, "repeat": [ 1, 5 ] },
        { "item": "metal_RPG_die", "x": 2, "y": 3, "chance": 10 },
        { "item": "RPG_die", "x": [ 1, 2 ], "y": [ 2, 3 ], "chance": 90, "repeat": [ 1, 4 ] }
      ],
      "place_monsters": [ { "monster": "GROUP_VANILLA_ONLY_HUMANS", "x": [ 2, 21 ], "y": [ 2, 21 ], "density": 0.1 } ]
    }
  }
]