[
  {
    "type": "mapgen",
    "method": "json",
    "om_terrain": [ "basement" ],
    "//": "used by house_31 and house_32",
    "weight": 250,
    "object": {
      "rotation": [ 0, 3 ],
      "fill_ter": "t_thconc_floor",
      "rows": [
        "111111                  ",
        "1...i1                  ",
        "1&...1                  ",
        "1....1                  ",
        "111+11111111111111111111",
        "1H+,,nFFFn,,,l,,,,zzzzz1",
        "1W+,,,,,,,,n,,,,,,,,,,,1",
        "111nnnnnnnnn,,,,,,A,,,,1",
        "1BB,,,,,,,,,,,,,,###,,,1",
        "1B,,,,,,,,,,,,,,A###A,,1",
        "1B,,,,,,,,,,,,,,,###,,,1",
        "1B,,,,,,,,,,,,,,,A,A,,,1",
        "1B,,,,,,,,,,,,,,,,,,,,,1",
        "1,,#####,,,,,,MT,,zzzzz1",
        "1S,,,,,,,S1,,11111111111",
        "1SnSSSSSnS1,,1          ",
        "11111111111++1          ",
        "          1..1          ",
        "          1<<1          ",
        "          1111          ",
        "                        ",
        "                        ",
        "                        ",
        "                        "
      ],
      "furniture": { "H": "f_home_furnace", "W": [ "f_water_heater", "f_water_heater_family" ], "z": "f_cardboard_box" },
      "liquids": { "W": { "liquid": "water_clean", "amount": [ 0, 100 ] } },
      "palettes": [ "basement_game" ],
      "place_loot": [
        { "item": "dnd_handbook", "x": 18, "y": 8, "chance": 100 },
        { "item": "novel_fantasy", "x": [ 17, 19 ], "y": [ 8, 10 ], "chance": 60, "repeat": [ 0, 4 ] },
        { "group": "wf_char_sheets", "x": [ 17, 19 ], "y": [ 9, 10 ], "chance": 80, "repeat": [ 1, 5 ] },
        { "item": "metal_RPG_die", "x": 18, "y": 8, "chance": 10 },
        { "item": "RPG_die", "x": [ 17, 19 ], "y": [ 8, 10 ], "chance": 90, "repeat": [ 1, 4 ] }
      ],
      "mapping": {
        "F": { "items": [ { "item": "fridgesnacks", "chance": 80, "repeat": [ 1, 3 ] } ] },
        "#": { "items": [ { "item": "fast_food", "chance": 40 } ] },
        "B": { "items": [ { "item": "homebooks", "chance": 30, "repeat": [ 1, 3 ] } ] },
        "M": { "items": [ { "item": "phones", "chance": 70, "repeat": [ 0, 5 ] } ] },
        "z": { "items": [ { "item": "costume_all", "chance": 75, "repeat": [ 1, 3 ] } ] }
      },
      "place_monsters": [ { "monster": "GROUP_ZOMBIE", "x": [ 2, 22 ], "y": [ 5, 12 ], "chance": 2 } ],
      "place_monster": [ { "monster": "mon_dragon_dummy", "x": 22, "y": 9, "chance": 10 } ]
    }
  }
]